11111111
100C0C01
10111101
10E11101
101C1101
10111001
10000C01
11111111