11111111111111111111111
1C000000000000100000001
100000000000000P000C001
1101110000111100C000001
1E000000001111000000001
11111111000111000000001
10000000000001000000001
10C0000000000100000C001
110001000011110000CCC01
10000000000C0000000C001
11111111111111111111111
