1111111111111111111111
1ECCCCCCCCCCCCCCCCCCC1
1C1CC1C1CC1CCCCC1CC1C1
1C1CC1CC1C1C1C1CCCC1C1
1PCCCCCBCCCBCCCCBCCCC1
1111111111111111111111