1111111111
1C000000P1
1C00000001
10000CCCC1
1C00000001
1C000000E1
1000000001
10000C0001
1CCCCC0001
1111111111
