1111111111111111111111
1E000000000000CC000001
1C10010100100000100101
10100100101C1C100001C1
1P00000BC0CBCCCCBC00C1
1111111111111111111111