1111111111111111111111
1E00000V000000CC000001
1C10010100100000100101
10100100101C1C100001C1
1P0V000BC0CBCCCCBC00C1
1111111111111111111111