1111111111
1PBVCE1111
1111111111